RWWWWWWWWWWWWWWWWWWWWWWWWWWWWWWWWWWWWWR
W                                     W
W                                     W
W     C C    B             C          W
W                                     W
W                                     W
W                                     W
W          B                 B        W
W                                     W
W                                     W
W                                     W
W                                     W
W                                     W
WWWWWWWWWWWWWWWWWWWWWWWWWWWWWWWWWWWWWWR