R#$$$$$$$$$$$$$$$$$$$$$$$#R
#                         #
$ @                       $
$ B           C           $
$ @   B   !               $
$ B                       $
$    !!!!!!               $
$     !    BBBBBB         $
$        C       B        $
$                         $
$                         $
$                         $
$                         $
#                         #
R#$$$$$$$$$$$$$$$$$$$$$$$#R