RBBBBBBBBBBBBR
B       BC   B
B  !         B
B BB      !! B
B   !        B
B  !      BC B
B    CB    ! B
B            B
RBBBBBBBBBBBBR