R#BBBBBBBBBBBBBBBBBBBBBB#R
#                        #
BBBBB               %%%  B
$   BBB       C          B
B     B   !              B
$    %%%%%%%%%%%%        B
B    !!!!!!              B
$    %!%   BBBBBB        B
B               B        B
$      %%%               B
B           %%%          B
$       %%%              B
B                        B
#   %%%                  #
R#BBBBBBBBBBBBBBBBBBBBBB#R