R#$$$$$$$$$$$$$$$$$$$$$$$#R
#B@    @                  #
$C@    B                  $
$BBB@BB@                  $
$      B                  $
$      @                  $
$BBB@BBB@BBBBBBB          $
$  C  B@@@B     B         $
$    B@B@BC     B         $
$BBBBB  BBBB@BBB          $
$    @                    $
$    @                    $
$    B                    $
#    B                    #
R#$$$$$$$$$$$$$$$$$$$$$$$#R