R#$$$$$$$$$$$$$$$$$$$$$$$#R
#B                        #
$      B                  $
$BBB BB                   $
$      B                  $
$                         $
$BBB BBB BBBBBBB          $
$     B   B    CB         $
$    B B B      B         $
$BBBBB  BBBB BBB          $
$                         $
$                         $
$    B                    $
#    B                    #
R#$$$$$$$$$$$$$$$$$$$$$$$#R