R#$$$$$$$$$$$$$$$$$$$$$$$#R
#B            B  B        #
$C     B      BCC@        $
$BBB BB       BBBB        $
$      B                  $
$   C                     $
$BBB BBB BB               $
$     B   B    CB         $
$    B B B      B         $
$              @BBB       $
$BBBBBBBBBBBBB@@@@@BBBBBBB$
$@BBBBBBBBBBBBBBB@BBBBBBBB$
$@BBBB@@@                 $
# C C C B                 #
R#$$$$$$$$$$$$$$$$$$$$$$$#R