R#BB$BB$BB$BB$BB$BB$BB$BB#R
#                         #
B @                       B
$ B           C           $
B @   B   !               B
$ B                       $
B    !!!!!!               B
$     !    BBBBBB         $
B        C       B        B
$                         $
B                         B
$                         $
B                         B
#                         #
R#BB$BB$BB$BB$BB$BB$BB$BB#R