R#$$$$$$$$$$$$$$$$$$$$$$$#R
#                         #
$                         $
$             C           $
$         !               $
$                         $
$    !!!!!!               $
$     !                   $
$        C                $
$BBBBB                    $
$    @                    $
$    @                    $
$    B                    $
#    B                    #
R#$$$$$$$$$$$$$$$$$$$$$$$#R